1111111
100011
11000P1
1000111
1E11111
10000C1