1111111
1000C11
111P111
11101C1
1110111
1110E11
1111111