11111111111111111111
100000P0000011000001
100011111000011C0001
100000C0100000001101
11110000111110001101
100100C000000C001101
1C011111111111000011
1000000C0001111C0001
10001111000100000001
10000001000101111101
100CC000100000000001
101111110C0000111111
101000000C0000000001
10101111111000C00001
10000000001000111001
11110000C01111100001
1C000000C00000000001
10111100C00111111111
10000000C00000000E01
11111111111111111111